GGGGGGGGGGGGGGGGGGGGGGGGGGGGGGGGGGGGGGGGGGGGGGGGGGGGGGGGGGGGGGGGGGGGGGGGGGGGG
GGGGGGGGGGGGGGGGGGGGGGGGGGGGGGGGGGGGGGGGGGGGGGGGGGGGGGGGGGGGGGGGGGGGGGGGGGGGG
GGGGGGGGGGGGGGGGGGGGGGGGGGGGGGGGGGGGGGGGGGGGGGGGGGGGGGGGGGGGGGGGGGGGGGGGGGGGG
GGGGGGGGGGGGGGGGGGGGGGGGGGGGGGGGGGGGGGGGGGGGGGGGGGGGGGGGGGGGGGGGGGGGGGGGGGGGG
GGGGGGGGGGGGGGGGGGGGGGGGGGGGGGGGGGGGGGGGGGGGGGGGGGGGGGGGGGGGGGGGGGGGGGGGGGGGG
GGGGGGGGGGGGGGGGGGGGGGGGGGGGGGGGGG000000000GGGGGGGGGGGGGGGGGGGGGGGGGGGGGGGGGG
GGGGGGGGGGGGGGGGGGGGGGGGGGGGGGG0000       0000GGGGGGGGGGGGGGGGGGGGGGGGGGGGGGG
GGGGGGGGGGGGGGGGGGGGGGGGGGGGG000             000GGGGGGGGGGGGGGGGGGGGGGGGGGGGG
GGGGGGGGGGGGGGGGGGGGGGGGGGG000                 000GGGGGGGGGGGGGGGGGGGGGGGGGGG
GGGGGGGGGGGGGGGGGGGGGGGGGG00                     00GGGGGGGGGGGGGGGGGGGGGGGGGG
GGGGGGGGGGGGGGGGGGGGGGGGG00                       00GGGGGGGGGGGGGGGGGGGGGGGGG
GGGGGGGGGGGGGGGGGGGGGGGG00            *            00GGGGGGGGGGGGGGGGGGGGGGGG
GGGGGGGGGGGGGGGGGGGGGGG00                           00GGGGGGGGGGGGGGGGGGGGGGG
GGGGGGGGGGGGGGGGGGGGGG00                             00GGGGGGGGGGGGGGGGGGGGGG
GGGGGGGGGGGGGGGGGGGGG00                               00GGGGGGGGGGGGGGGGGGGGG
GGGGGGGGGGGGGGGGGGGGG0                0                0GGGGGGGGGGGGGGGGGGGGG
GGGGGGGGGGGGGGGGGGGG00      %     0   0   0     %      00GGGGGGGGGGGGGGGGGGGG
GGGGGGGGGGGGGGGGGGGG0            X X  0  X X            0GGGGGGGGGGGGGGGGGGGG
GGGGGGGGGGGGGGGGGGG00           0 0   0   0 0           00GGGGGGGGGGGGGGGGGGG
GGGGGGGGGGGGGGGGGGG0           X X         X X           0GGGGGGGGGGGGGGGGGGG
GGGGGGGGGGGGGGGGGGG0          0 0     X     0 0          0GGGGGGGGGGGGGGGGGGG
GGGGGGGGGGGGGGGGGG00         X X   00   00   X X         00GGGGGGGGGGGGGGGGGG
GGGGGGGGGGGGGGGGGG0         0 0   0+     +0   0 0         0GGGGGGGGGGGGGGGGGG
GGGGGGGGGGGGGGGGGG0          X    0   P   0    X          0GGGGGGGGGGGGGGGGGG
GGGGGGGGGGGGGGGGGG0                                       0GGGGGGGGGGGGGGGGGG
GGGGGGGGGGGGGGGGGG0  *    0000   X    C    X   0000   *   0GGGGGGGGGGGGGGGGGG
GGGGGGGGGGGGGGGGGG0                                       0GGGGGGGGGGGGGGGGGG
GGGGGGGGGGGGGGGGGG0          X    0       0    X          0GGGGGGGGGGGGGGGGGG
GGGGGGGGGGGGGGGGGG0         0 0   0+     +0   0 0         0GGGGGGGGGGGGGGGGGG
GGGGGGGGGGGGGGGGGG00         X X   00   00   X X         00GGGGGGGGGGGGGGGGGG
GGGGGGGGGGGGGGGGGGG0          0 0     X     0 0          0GGGGGGGGGGGGGGGGGGG
GGGGGGGGGGGGGGGGGGG0           X X         X X           0GGGGGGGGGGGGGGGGGGG
GGGGGGGGGGGGGGGGGGG00           0 0   0   0 0           00GGGGGGGGGGGGGGGGGGG
GGGGGGGGGGGGGGGGGGGG0            X X  0  X X            0GGGGGGGGGGGGGGGGGGGG
GGGGGGGGGGGGGGGGGGGG00      %     0   0   0     %      00GGGGGGGGGGGGGGGGGGGG
GGGGGGGGGGGGGGGGGGGGG0                0                0GGGGGGGGGGGGGGGGGGGGG
GGGGGGGGGGGGGGGGGGGGG00                               00GGGGGGGGGGGGGGGGGGGGG
GGGGGGGGGGGGGGGGGGGGGG00                             00GGGGGGGGGGGGGGGGGGGGGG
GGGGGGGGGGGGGGGGGGGGGGG00                           00GGGGGGGGGGGGGGGGGGGGGGG
GGGGGGGGGGGGGGGGGGGGGGG00                         00GGGGGGGGGGGGGGGGGGGGGGGGG
GGGGGGGGGGGGGGGGGGGGGGGGG00           *           00GGGGGGGGGGGGGGGGGGGGGGGGG
GGGGGGGGGGGGGGGGGGGGGGGGGG00                     00GGGGGGGGGGGGGGGGGGGGGGGGGG
GGGGGGGGGGGGGGGGGGGGGGGGGGG000                 000GGGGGGGGGGGGGGGGGGGGGGGGGGG
GGGGGGGGGGGGGGGGGGGGGGGGGGGGG000             000GGGGGGGGGGGGGGGGGGGGGGGGGGGGG
GGGGGGGGGGGGGGGGGGGGGGGGGGGGGGG0000       0000GGGGGGGGGGGGGGGGGGGGGGGGGGGGGGG
GGGGGGGGGGGGGGGGGGGGGGGGGGGGGGGGGG000000000GGGGGGGGGGGGGGGGGGGGGGGGGGGGGGGGGG
GGGGGGGGGGGGGGGGGGGGGGGGGGGGGGGGGGGGGGGGGGGGGGGGGGGGGGGGGGGGGGGGGGGGGGGGGGGGG
GGGGGGGGGGGGGGGGGGGGGGGGGGGGGGGGGGGGGGGGGGGGGGGGGGGGGGGGGGGGGGGGGGGGGGGGGGGGG
GGGGGGGGGGGGGGGGGGGGGGGGGGGGGGGGGGGGGGGGGGGGGGGGGGGGGGGGGGGGGGGGGGGGGGGGGGGGG
GGGGGGGGGGGGGGGGGGGGGGGGGGGGGGGGGGGGGGGGGGGGGGGGGGGGGGGGGGGGGGGGGGGGGGGGGGGGG
GGGGGGGGGGGGGGGGGGGGGGGGGGGGGGGGGGGGGGGGGGGGGGGGGGGGGGGGGGGGGGGGGGGGGGGGGGGGG
