YYYYYYYYYYYYYYYYYYYYYYYYYYYYYYYYYYYYYYYYYYYYYYYYYYYYYYYYYYYYYYY
YYYYYYYYYYYYYYYYYYYYYYYYYYYYYYYYYYYYYYYYYYYYYYYYYYYYYYYYYYYYYYY
YYYYYYYYYYYYYYYYYYYYYYYYYYYYYYYYYYYYYYYYYYYYYYYYYYYYYYYYYYYYYYY
YYYYYYYYYYYYYYYYYYYYYYYYYYYYYYYYYYYYYYYYYYYYYYYYYYYYYYYYYYYYYYY
YYYYYYYYYYYYYYYYYYYY000000000000000000000000YYYYYYYYYYYYYYYYYYY
YYYYYYYYYYYYYYYYYYYY000000000000000000000000YYYYYYYYYYYYYYYYYYY
YYYYYYYYYYYYYYYYYYYY00B                  B00YYYYYYYYYYYYYYYYYYY
YYYYYYYYYYYYYYYYYYYY00 XX XS XX BXX XX XX 00YYYYYYYYYYYYYYYYYYY
YYYYYYYYYYYYYYYYYYYY00 XX XX XX  XH XX XX 00YYYYYYYYYYYYYYYYYYY
YYYYYYYYYYYYYYYYYYYY00 XX XX   00   XX XX 00YYYYYYYYYYYYYYYYYYY
YYYYYYYYYYYYYYYYYYYY00 XX XX XX00XX XX XX 00YYYYYYYYYYYYYYYYYYY
YYYYYYYYYYYYYYYYYYYY00 XXBXX XX  HX XXBXX 00YYYYYYYYYYYYYYYYYYY
YYYYYYYYYYYYYYYYYYYY00 XX XX        XX XH 00YYYYYYYYYYYYYYYYYYY
YYYYYYYYYYYYYYYYYYYY00 HX XX XX  XX XX XX 00YYYYYYYYYYYYYYYYYYY
YYYYYYYYYYYYYYYYYYYY00 XX XX XX  XX XX XX 00YYYYYYYYYYYYYYYYYYY
YYYYYYYYYYYYYYYYYYYY00                    00YYYYYYYYYYYYYYYYYYY
YYYYYYYYYYYYYYYYYYYY00B  XXX        XXX  B00YYYYYYYYYYYYYYYYYYY
YYYYYYYYYYYYYYYYYYYY000  XXH XX BXX HXX  000YYYYYYYYYYYYYYYYYYY
YYYYYYYYYYYYYYYYYYYY00       XXXXXX       00YYYYYYYYYYYYYYYYYYY
YYYYYYYYYYYYYYYYYYYY00 XX XX XXHXXX XX XX 00YYYYYYYYYYYYYYYYYYY
YYYYYYYYYYYYYYYYYYYY00 XX XX XX  XX XX XX 00YYYYYYYYYYYYYYYYYYY
YYYYYYYYYYYYYYYYYYYY00 XX XX XD  HX XX XX 00YYYYYYYYYYYYYYYYYYY
YYYYYYYYYYYYYYYYYYYY00 XX XS        XX XX 00YYYYYYYYYYYYYYYYYYY
YYYYYYYYYYYYYYYYYYYY00 XX XX   P    XX XX 00YYYYYYYYYYYYYYYYYYY
YYYYYYYYYYYYYYYYYYYY00 XX XX  XXXS  XX XX 00YYYYYYYYYYYYYYYYYYY
YYYYYYYYYYYYYYYYYYYY00        XC X        00YYYYYYYYYYYYYYYYYYY
YYYYYYYYYYYYYYYYYYYY000000000000000000000000YYYYYYYYYYYYYYYYYYY
YYYYYYYYYYYYYYYYYYYY000000000000000000000000YYYYYYYYYYYYYYYYYYY
YYYYYYYYYYYYYYYYYYYYYYYYYYYYYYYYYYYYYYYYYYYYYYYYYYYYYYYYYYYYYYY
YYYYYYYYYYYYYYYYYYYYYYYYYYYYYYYYYYYYYYYYYYYYYYYYYYYYYYYYYYYYYYY
YYYYYYYYYYYYYYYYYYYYYYYYYYYYYYYYYYYYYYYYYYYYYYYYYYYYYYYYYYYYYYY
YYYYYYYYYYYYYYYYYYYYYYYYYYYYYYYYYYYYYYYYYYYYYYYYYYYYYYYYYYYYYYY