0000000000000000000
0XXXXXXXXXXXXXXXXX0
0  X       X     X0
0  X       X  S  X0
0XXX   0   X     X0
0C   P        H EX0
0XXX   0   X     X0
0  X       X  D  X0
0  X       X     X0
0XXXXXXXXXXXXXXXXX0
0000000000000000000
