YYYYYYYYYYYYYYYYYYYYYYYYYYYYYYYYYYYYYYYYYYYYYYYYYYYYYYYYYYYYYYYYYYYYYYYYYYYYY
YYYYYYYYYYYYYYYYYYYYYYYYYYYYYYYYYYYYYYYYYYYYYYYYYYYYYYYYYYYYYYYYYYYYYYYYYYYYY
YYYYYYYYYYYYYYYYYYYYYYYYYYYYYYYYYYYYYYYYYYYYYYYYYYYYYYYYYYYYYYYYYYYYYYYYYYYYY
YYYYYYYYYYYYYYYYYYYYYYYYYYYYYYYYYYYYYYYYYYYYYYYYYYYYYYYYYYYYYYYYYYYYYYYYYYYYY
YYYYYYYYYYYYYY0000000000000000000000000000000000000000000000000YYYYYYYYYYYYYY
YYYYYYYYYYYYYY0XXXXXXXXXXXXXXXXXXXXXXXXXXXXXXXXXXXXXXXXXXXXXXX0YYYYYYYYYYYYYY
YYYYYYYYYYYYYY0X   P        X     X           X    H     X    X0YYYYYYYYYYYYY
YYYYYYYYYYYYYY0X        X   XXXXXXXX    S    XXXXXXX     XXXX X0YYYYYYYYYYYYY
YYYYYYYYYYYYYY0X  S     X   X B            X         B    X   X0YYYYYYYYYYYYY
YYYYYYYYYYYYYY0XXX  0   X   XXXXXXX  H      XXXXXXXXXXXX      X0YYYYYYYYYYYYY
YYYYYYYYYYYYYY0XXX      X   X      X        X       X    X    X0YYYYYYYYYYYYY
YYYYYYYYYYYYYY0X        X  XXX B   XXX    XXXX      XXXXXX    X0YYYYYYYYYYYYY
YYYYYYYYYYYYYY0X   XXXXXXXX    XXXXXXXX X  XXX A    X   E     X0YYYYYYYYYYYYY
YYYYYYYYYYYYYY0X  XXXXXXXXXXXXXX   XXX     XXXXXX   XXXXXX    X0YYYYYYYYYYYYY
YYYYYYYYYYYYYY0X          H   X     B    XXXXX      XX     D  X0YYYYYYYYYYYYY
YYYYYYYYYYYYYY0XXX XXXXXXXXXXXXXXXX        XXXXXXXXXXXXXXXX   X0YYYYYYYYYYYYY
YYYYYYYYYYYYYY0X            B        X  X     XX     XXXXXXX X0YYYYYYYYYYYYYY
YYYYYYYYYYYYYY0X XXX    XXXXXXX  XXXXXXXX  D        XXXXXXX  X0YYYYYYYYYYYYYY
YYYYYYYYYYYYYY0X C                 XXXXXX     S     XXX      X0YYYYYYYYYYYYYY
YYYYYYYYYYYYYY0XXXXXXXXXXXXXXXXXXXXXXXXXXXXXXXXXXXXXXXXXXXXXXX0YYYYYYYYYYYYYY
YYYYYYYYYYYYYY0000000000000000000000000000000000000000000000000YYYYYYYYYYYYYY
YYYYYYYYYYYYYYYYYYYYYYYYYYYYYYYYYYYYYYYYYYYYYYYYYYYYYYYYYYYYYYYYYYYYYYYYYYYYY
YYYYYYYYYYYYYYYYYYYYYYYYYYYYYYYYYYYYYYYYYYYYYYYYYYYYYYYYYYYYYYYYYYYYYYYYYYYYY
YYYYYYYYYYYYYYYYYYYYYYYYYYYYYYYYYYYYYYYYYYYYYYYYYYYYYYYYYYYYYYYYYYYYYYYYYYYYY
YYYYYYYYYYYYYYYYYYYYYYYYYYYYYYYYYYYYYYYYYYYYYYYYYYYYYYYYYYYYYYYYYYYYYYYYYYYYY
