WWWWWWWWWWWWWWWWWWWWWWWWWWWWWWWWWWWWWWWWWWWWWWWWWWWWWWWWWWWWWWWWWWWWWWWWWWWWWWWWWWWWWWWWWWWWWWWWWWWWWWWWWW
WWWWWWWWWWWWWWWWWWWWWWWWWWWWWWWWWWWWWWWWWWWWWWWWWWWWWWWWWWWWWWWWWWWWWWWWWWWWWWWWWWWWWWWWWWWWWWWWWWWWWWWWWW
WWWWWWWWWWWWWWWWWWWWWWWWWWWWWWWWWWWWWWWWWWWWWWWWWWWWWWWWWWWWWWWWWWWWWWWWWWWWWWWWWWWWWWWWWWWWWWWWWWWWWWWWWWW
WWWWWWWWWWWWWWWWWWWWWWWWWWWWWWWWWWWWWWWWWWWWWWWWWWWWWWWWWWWWWWWWWWWWWWWWWWWWWWWWWWWWWWWWWWWWWWWWWWWWWWWWWW
WWWWWWWWWWWWWWWWWWWWWWWWWWWWWWWWWWWWWWWWWWWWWWWWWWWWWWWWWWWWWWWWWWWWWWWWWWWWWWWWWWWWWWWWWWWWWWWWWWWWWWWWWW
WWWWWWWWWWWWWWWWWWWWWWWWWWWWWWWWWWWWWWWWWWWWWWWWWWWWWWWWWWWWWWWWWWWWWWWWWWWWWWWWWWWWWWWWWWWWWWWWWWWWWWWWWWW
WWWWWWWWWWWWWWW0000000000000000000000000000WWWWWWWWWW0000000000000000000000000000000000000000WWWWWWWWWWWWWWWW
WWWWWWWWWWWWWW0XXXXXXXXXXXXXXXXXXXXXXXXXX0WWWWWWWWWW0XXXXXXXXXXXXXXXXXXXXXXXXXXXXXXXXXXXXXX0WWWWWWWWWWWWWWWW
WWWWWWWWWWWWWW0X                        X0WWWWWWWWWW0X            X               X    E  X0WWWWWWWWWWWWWWWW
WWWWWWWWWWWWWW0X                        X0WWWWWWWWWW0X     B      X          X    X       X0WWWWWWWWWWWWWWWW
WWWWWWWWWWWWWW0X                        X0WWWWWWWWWW0X            X          X    X       X0WWWWWWWWWWWWWWWW
WWWWWWWWWWWWWW0X        S               X000000000000X            X     B    X  B  H   XXXX0WWWWWWWWWWWWWWWW
WWWWWWWWWWWWWW0X                        XXXXXXXXXXXXXX                        X           X0WWWWWWWWWWWWWWWW
WWWWWWWWWWWWWW0X C  P   D               X                                      X          X0WWWWWWWWWWWWWWWW
WWWWWWWWWWWWWW0X                        X                          X            XXX   B   X0WWWWWWWWWWWWWWWW
WWWWWWWWWWWWWW0X                        X                       B   XXXXX   B             X0WWWWWWWWWWWWWWWW
WWWWWWWWWWWWWW0X                        XXXXXXXXXXXXXXXXXXXXXXXXXXXXXXXXXXXXXXXXXXXXXXXXXXX0WWWWWWWWWWWWWWWW
WWWWWWWWWWWWWW0XXXXXXXXXXX          XXXXX000000000000000000000000000000000000000000000000000WWWWWWWWWWWWWWWW
WWWWWWWWWWWWWW000000000000XXXXXXXXXXX00000WWWWWWWWWWWWWWWWWWWWWWWWWWWWWWWWWWWWWWWWWWWWWWWWWWWWWWWWWWWWWWWWWW
WWWWWWWWWWWWWWWWWWWWWWWW0           0WWWWWWWWWWWWWWWWWWWWWWWWWWWWWWWWWWWWWWWWWWWWWWWWWWWWWWWWWWWWWWWWWWWWWW
WWWWWWWWWWWWWWWWWWWWWWWW0           0WWWWWWWWWWWWWWWWWWWWWWWWWWWWWWWWWWWWWWWWWWWWWWWWWWWWWWWWWWWWWWWWWWWWWW
WWWWWWWWWWWWWWWWWWWWWWWW0           0WWWWWWWWWWWWWWWWWWWWWWWWWWWWWWWWWWWWWWWWWWWWWWWWWWWWWWWWWWWWWWWWWWWWWW
WWWWWWWWWWWWWWWWWWWWWWWW0           0WWWWWWWWWWWWWWWWWWWWWWWWWWWWWWWWWWWWWWWWWWWWWWWWWWWWWWWWWWWWWWWWWWWWWW
WWWWWWWWWWWWWW00000000000           000000000000WWWWWWWWWWWWWWWWWWWWWWWWWWWWWWWWWWW
WWWWWWWWWWWWWW0                                 0WWWWWWWWWWWWWWWWWWWWWWWWWWWWWWWWWW
WWWWWWWWWWWWWW0         XXXXXXXXXXXXXXX         0WWWWWWWWWWWWWWWWWWWWWWWWWWWWWWWWWW
WWWWWWWWWWWWWW0         X      H      X         0WWWWWWWWWWWWWWWWWWWWWWWWWWWWWWWWWW
WWWWWWWWWWWWWW0         X             X         0WWWWWWWWWWWWWWWWWWWWWWWWWWWWWWWWWW
WWWWWWWWWWWWWW0XXXXXXXXXX  A       A  XXXXXXXXXX0WWWWWWWWWWWWWWWWWWWWWWWWWWWWWWWWWW
WWWWWWWWWWWWWW0         X             X         0WWWWWWWWWWWWWWWWWWWWWWWWWWWWWWWWWW
WWWWWWWWWWWWWW0         X      E      X         0WWWWWWWWWWWWWWWWWWWWWWWWWWWWWWWWWW
WWWWWWWWWWWWWW0         XXXXXXXXXXXXXXX         0WWWWWWWWWWWWWWWWWWWWWWWWWWWWWWWWWW
WWWWWWWWWWWWWW0                                 0WWWWWWWWWWWWWWWWWWWWWWWWWWWWWW
WWWWWWWWWWWWWW00000000000000000000000000000000000WWWWWWWWWWWWWWWWWWWWWWWW
WWWWWWWWWWWWWWWWWWWWWWWWWWWWWWWWWWWWWWWWWWWWWWWWWWWWWWWWWWWWWWWWWWWWWW
WWWWWWWWWWWWWWWWWWWWWWWWWWWWWWWWWWWWWWWWWWWWWWWWWWWWWWWWWWWWWWWW
WWWWWWWWWWWWWWWWWWWWWWWWWWWWWWWWWWWWWWWWWWWWWWWWWWWWWWWWWWWWWWWWW
WWWWWWWWWWWWWWWWWWWWWWWWWWWWWWWWWWWWWWWWWWWWWWWWWWWWWWWWWWWWWW
WWWWWWWWWWWWWWWWWWWWWWWWWWWWWWWWWWWWWWWWWWWWWWWWWWWWWWWWWWWWW
WWWWWWWWWWWWWWWWWWWWWWWWWWWWWWWWWWWWWWWWWWWWWWWWWWWWWWWWWWWW
WWWWWWWWWWWWWWWWWWWWWWWWWWWWWWWWWWWWWWWWWWWWWWWWWWWWWWWWWWWW
