00000000000000000000000
0XXXXXXXXXXXXXXXXXXXXX0
0  X       X        EX0
0  X       X  S      X0
0XXX   0   X     B  XX0
0C   P        H      X0
0XXX   0   X         X0
0  X       X  D  B   X0
0  X       X         X0
0  X       X 0XXXX0  X0
0  XXX    XX         X0
0  X          B      X0
0  XXX XXX XX   X X  X0
0  X                 X0
0  X   H   X    D    X0
0XXXXXXXXXXXXXXXXXXXXX0
00000000000000000000000
