WWWWWWWWWWWWWWWWWWWWWWWWWWWWWWWWWWWWWWWWWWWWWWWWWWWWWWWWWWWWWWWWWWWWWWWWWWWWWWWWWWWWWWWWWW
WWWWWWWWWWWWWWWWWWWWWWWWWWWWWWWWWWWWWWWWWWWWWWWWWWWWWWWWWWWWWWWWWWWWWWWWWWWWWWWWWWWWWWWWWW
WWWWWWWWWWWWWWWWWWWWWWWWWWWWWWWWWWWWWWWWWWWWWWWWWWWWWWWWWWWWWWWWWWWWWWWWWWWWWWWWWWWWWWWWWW
WWWWWWWWWWWWWWWWWWWWWWWWWWWWWWWWWWWWWWWWWWWWWWWWWWWWWWWWWWWWWWWWWWWWWWWWWWWWWWWWWWWWWWWWWW
WWWWWWWWWWWWWWWWWWWWWWWWWWWWWWWWWWWWWWWWWWWWWWWWWWWWWWWWWWWWWWWWWWWWWWWWWWWWWWWWWWWWWWWWWW
WWWWWWWWWWWWWWWWWWWWWWWWWWWWWWWWWWWWWWWWWWWWWWWWWWWWWWWWWWWWWWWWWWWWWWWWWWWWWWWWWWWWWWWWWW
WWWWWWWWWWWWW0000000000000000000000000000000000000000000000000000000000000000WWWWWWWWWWWWW
WWWWWWWWWWWWW0XXXXXXXXXXXXXXXXXXXXXXXXXXXXXXXXXXXXXXXXXXXXXXXXXXXXXXXXXXXXXX0WWWWWWWWWWWWW
WWWWWWWWWWWWW0X                         XXXXXXXXX                          X0WWWWWWWWWWWWW
WWWWWWWWWWWWW0X                      XXX        XXX                        X0WWWWWWWWWWWWW
WWWWWWWWWWWWW0X                   XXX              XXX                     X0WWWWWWWWWWWWW
WWWWWWWWWWWWW0X       S        XXX                    XXX         H        X0WWWWWWWWWWWWW
WWWWWWWWWWWWW0X              00                          00                X0WWWWWWWWWWWWW
WWWWWWWWWWWWW0X            00           XXXXXXXX           00              X0WWWWWWWWWWWWW
WWWWWWWWWWWWW0X          XX          XX         XX           XX            X0WWWWWWWWWWWWW
WWWWWWWWWWWWW0X         X           X             X             X          X0WWWWWWWWWWWWW
WWWWWWWWWWWWW0X       XX            X       K     X              XX        X0WWWWWWWWWWWWW
WWWWWWWWWWWWW0X      X              X             X                X       X0WWWWWWWWWWWWW
WWWWWWWWWWWWW0X     X               XX           XX                 X      X0WWWWWWWWWWWWW
WWWWWWWWWWWWW0X    X                  XX       XX                    X     X0WWWWWWWWWWWWW
WWWWWWWWWWWWW0X    X                    X     X                      X     X0WWWWWWWWWWWWW
WWWWWWWWWWWWW0X    X                    X     X                      X     X0WWWWWWWWWWWWW
WWWWWWWWWWWWW0X    X                    X     X                      X     X0WWWWWWWWWWWWW
WWWWWWWWWWWWW0X    X                  XX       XX                    X     X0WWWWWWWWWWWWW
WWWWWWWWWWWWW0X     X               XX           XX                 X      X0WWWWWWWWWWWWW
WWWWWWWWWWWWW0X      X              X             X                X       X0WWWWWWWWWWWWW
WWWWWWWWWWWWW0X       XX            X      P      X              XX        X0WWWWWWWWWWWWW
WWWWWWWWWWWWW0X         X           X             X             X          X0WWWWWWWWWWWWW
WWWWWWWWWWWWW0X          00          XX         XX           00            X0WWWWWWWWWWWWW
WWWWWWWWWWWWW0X            00           XXXXXXXX           00              X0WWWWWWWWWWWWW
WWWWWWWWWWWWW0X              00                          00                X0WWWWWWWWWWWWW
WWWWWWWWWWWWW0X      D         XXX                    XXX                  X0WWWWWWWWWWWWW
WWWWWWWWWWWWW0X                   XXX              XXX                     X0WWWWWWWWWWWWW
WWWWWWWWWWWWW0X                      XXX        XXX                        X0WWWWWWWWWWWWW
WWWWWWWWWWWWW0X                         00000000                           X0WWWWWWWWWWWWW
WWWWWWWWWWWWW0XXXXXXXXXXXXXXXXXXXXXXXXXXXXXXXXXXXXXXXXXXXXXXXXXXXXXXXXXXXXXX0WWWWWWWWWWWWW
WWWWWWWWWWWWW0000000000000000000000000000000000000000000000000000000000000000WWWWWWWWWWWWW
WWWWWWWWWWWWWWWWWWWWWWWWWWWWWWWWWWWWWWWWWWWWWWWWWWWWWWWWWWWWWWWWWWWWWWWWWWWWWWWWWWWWWWWWWW
WWWWWWWWWWWWWWWWWWWWWWWWWWWWWWWWWWWWWWWWWWWWWWWWWWWWWWWWWWWWWWWWWWWWWWWWWWWWWWWWWWWWWWWWWW
WWWWWWWWWWWWWWWWWWWWWWWWWWWWWWWWWWWWWWWWWWWWWWWWWWWWWWWWWWWWWWWWWWWWWWWWWWWWWWWWWWWWWWWWWW
WWWWWWWWWWWWWWWWWWWWWWWWWWWWWWWWWWWWWWWWWWWWWWWWWWWWWWWWWWWWWWWWWWWWWWWWWWWWWWWWWWWWWWWWWW
WWWWWWWWWWWWWWWWWWWWWWWWWWWWWWWWWWWWWWWWWWWWWWWWWWWWWWWWWWWWWWWWWWWWWWWWWWWWWWWWWWWWWWWWWW
WWWWWWWWWWWWWWWWWWWWWWWWWWWWWWWWWWWWWWWWWWWWWWWWWWWWWWWWWWWWWWWWWWWWWWWWWWWWWWWWWWWWWWWWWW