00000000000000000000000
0XXXXXXXXXXXXXXXXXXXXX0
0X                   X0
0X                   X0
0X 3  1         2  4 X0
0X                   X0
0X                   X0
0X X X X X X X X X X X0
0XXXXXXXXXXXXXXXXXXXXX0
00000000000000000000000
