TTTTTTTTTTTTTTTTTTTTTTTTTTTTTTTTTTTTTTTTTTTTTTTTTTTTTTTTTTTTTTTTTTTTTTTTT
TTTTTTTTTTTTTTTTTTTTTTTTTTTTTTTTTTTTTTTTTTTTTTTTTTTTTTTTTTTTTTTTTTTTTTTTT
TTTTTTTTTTTTTTTTTTTTTTTTTTTTTTTTTTTTTTTTTTTTTTTTTTTTTTTTTTTTTTTTTTTTTTTTT
TTTTTTTTTTTTTTTTTTTTTTTTTTTTTTTTTTTTTTTTTTTTTTTTTTTTTTTTTTTTTTTTTTTTTTTTT
TTTTTTTTTTTTTTTTTTTTTTTTTTTTTTTTTTTTTTTTTTTTTTTTTTTTTTTTTTTTTTTTTTTTTTTTT
TTTTTTTTTTTTTTTTTTTTTTTTTTTTTTTTTTTT0TTTTTTTTTTTTTTTTTTTTTTTTTTTTTTTTTTTT
TTTTTTTTTTTTTTTTTTTTTTTTTTTTTTTTTT00V00TTTTTTTTTTTTTTTTTTTTTTTTTTTTTTTTTT
TTTTTTTTTTTTTTTTTTTTTTTTTTTTTTTTT0H   H0TTTTTTTTTTTTTTTTTTTTTTTTTTTTTTTTT
TTTTTTTTTTTTTTTTTTTTTTTTTTTTTTT00       00TTTTTTTTTTTTTTTTTTTTTTTTTTTTTTT
TTTTTTTTTTTTTTTTTTTTTTTTTTTTTT0     0     0TTTTTTTTTTTTTTTTTTTTTTTTTTTTTT
TTTTTTTTTTTTTTTTTTTTTTTTTTTT00      0      00TTTTTTTTTTTTTTTTTTTTTTTTTTTT
TTTTTTTTTTTTTTTTTTTTTTTTTTT0    X   0    X   0TTTTTTTTTTTTTTTTTTTTTTTTTTT
TTTTTTTTTTTTTTTTTTTTTTTTTT0     X   0    X    0TTTTTTTTTTTTTTTTTTTTTTTTTT
TTTTTTTTTTTTTTTTTTTTTTTT00  S   X   0    X   S 00TTTTTTTTTTTTTTTTTTTTTTTT
TTTTTTTTTTTTTTTTTTTTTTT0     ! X    0     X !    0TTTTTTTTTTTTTTTTTTTTTTT
TTTTTTTTTTTTTTTTTTTTT00       X     0      X      00TTTTTTTTTTTTTTTTTTTTT
TTTTTTTTTTTTTTTTTTTT0        X    X 0 X     X       0TTTTTTTTTTTTTTTTTTTT
TTTTTTTTTTTTTTTTTT00      XXX    X  0  X     XXX     00TTTTTTTTTTTTTTTTTT
TTTTTTTTTTTTTTTTT0H             000 0 000             H0TTTTTTTTTTTTTTTTT
TTTTTTTTTTTTTTTTT0V  0          0H     H0          0  V0TTTTTTTTTTTTTTTTT
TTTTTTTTTTTTTTTTTT0   000      00        0      000   0TTTTTTTTTTTTTTTTTT
TTTTTTTTTTTTTTTTTT0      000X  0   XXX   0  X000      0TTTTTTTTTTTTTTTTTT
TTTTTTTTTTTTTTTTTT0          000         000          0TTTTTTTTTTTTTTTTTT
TTTTTTTTTTTTTTTTTTT0          0           0          0TTTTTTTTTTTTTTTTTTT
TTTTTTTTTTTTTTTTTTT0          X  X  C  X  X          0TTTTTTTTTTTTTTTTTTT
TTTTTTTTTTTTTTTTTTTT0 X      XX   X   X   XX      X 0TTTTTTTTTTTTTTTTTTTT
TTTTTTTTTTTTTTTTTTTT0 X    XX0S     P     D0XX    X 0TTTTTTTTTTTTTTTTTTTT
TTTTTTTTTTTTTTTTTTTT0  X     0             0     X  0TTTTTTTTTTTTTTTTTTTT
TTTTTTTTTTTTTTTTTTTTT0  0    000   XXX   000    0  0TTTTTTTTTTTTTTTTTTTTT
TTTTTTTTTTTTTTTTTTTTT0 # X     00       00     X # 0TTTTTTTTTTTTTTTTTTTTT
TTTTTTTTTTTTTTTTTTTTT0    X     000   000     X    0TTTTTTTTTTTTTTTTTTTTT
TTTTTTTTTTTTTTTTTTTTTT0   X    0   0V0   0    X   0TTTTTTTTTTTTTTTTTTTTTT
TTTTTTTTTTTTTTTTTTTTTT0       0   X   X   0       0TTTTTTTTTTTTTTTTTTTTTT
TTTTTTTTTTTTTTTTTTTTTT0H  0   0  XX000XX  0   0  H0TTTTTTTTTTTTTTTTTTTTTT
TTTTTTTTTTTTTTTTTTTTTTT0     X             X     0TTTTTTTTTTTTTTTTTTTTTTT
TTTTTTTTTTTTTTTTTTTTTTT0    0       X       0    0TTTTTTTTTTTTTTTTTTTTTTT
TTTTTTTTTTTTTTTTTTTTTTTT0   0      X#X      0   0TTTTTTTTTTTTTTTTTTTTTTTT
TTTTTTTTTTTTTTTTTTTTTTTT0  0      X   X      0  0TTTTTTTTTTTTTTTTTTTTTTTT
TTTTTTTTTTTTTTTTTTTTTTTT0       XX D D XX       0TTTTTTTTTTTTTTTTTTTTTTTT
TTTTTTTTTTTTTTTTTTTTTTTTT0V                   V0TTTTTTTTTTTTTTTTTTTTTTTTT
TTTTTTTTTTTTTTTTTTTTTTTTT00000000000000000000000TTTTTTTTTTTTTTTTTTTTTTTTT
TTTTTTTTTTTTTTTTTTTTTTTTTTTTTTTTTTTTTTTTTTTTTTTTTTTTTTTTTTTTTTTTTTTTTTTTT
TTTTTTTTTTTTTTTTTTTTTTTTTTTTTTTTTTTTTTTTTTTTTTTTTTTTTTTTTTTTTTTTTTTTTTTTT
TTTTTTTTTTTTTTTTTTTTTTTTTTTTTTTTTTTTTTTTTTTTTTTTTTTTTTTTTTTTTTTTTTTTTTTTT
TTTTTTTTTTTTTTTTTTTTTTTTTTTTTTTTTTTTTTTTTTTTTTTTTTTTTTTTTTTTTTTTTTTTTTTTT
TTTTTTTTTTTTTTTTTTTTTTTTTTTTTTTTTTTTTTTTTTTTTTTTTTTTTTTTTTTTTTTTTTTTTTTTT
                                        